0x00000000004afc2b
0x00000000004b2628
0x000000000043924f
0x00000000004395c8
0x00000000006c8c08
0x00000000006c879c
0x00000000006d32fa
0x00000000006d3046
0x00000000006c5889
0x000000000067295e
0x00000000004afb03
0x0000000000661f9d
0x000000000066275d
0x00000000004adea9
0x00000000006c5b24
0x000000000056461a
0x00000000004fe26d
0x00000000004f3cb3
0x000000000042c7ce
0x00000000004cb73a
